_ 0000 [0000]
[ 0004 [0000]
. 0002 [0000]
] 0002 [0000]
[ 0024 [0000]
, 0001 [0000]
. 0001 [0000]
[ 0010 [0000]
. 0001 [0000]
] 0008 [0000]
, 0001 [0000]
. 0002 [0000]
, 0003 [0000]
+ 0001 [0000]
, 0001 [0000]
+ -001 [0000]
, 0001 [0000]
> 0000 [-001]
, 0001 [0001]
> 0000 [0001]
[ 0022 [0000]
] 0021 [0000]
. 0002 [0000]
] 0005 [0000]
+ 0008 [0000]
[ 0054 [0000]
+ 0004 [0001]
> 0000 [0001]
[ 0040 [0000]
+ 0002 [0001]
> 0000 [0001]
+ 0003 [0001]
> 0000 [0001]
+ 0003 [0001]
> 0000 [0001]
+ 0001 [0001]
> 0000 [0001]
+ -001 [-004]
> 0000 [-004]
] 0029 [0000]
+ 0001 [0001]
> 0000 [0001]
+ 0001 [0001]
> 0000 [0001]
+ -001 [0001]
> 0000 [0001]
+ 0001 [0002]
> 0000 [0002]
[ 0051 [0000]
> 0000 [-001]
] 0049 [0000]
+ -001 [-001]
> 0000 [-001]
] 0026 [0000]
. 0001 [0002]
> 0000 [0002]
+ -003 [0001]
. 0001 [0001]
+ 0007 [0001]
. 0002 [0001]
+ 0003 [0001]
. 0001 [0001]
> 0000 [0001]
. 0001 [0002]
> 0000 [0002]
+ -001 [-001]
. 0001 [-001]
> 0000 [-001]
. 0001 [-001]
+ 0003 [-001]
. 0001 [-001]
+ -006 [-001]
. 0001 [-001]
+ -008 [-001]
. 0001 [-001]
> 0000 [-001]
+ 0001 [0002]
. 0001 [0002]
> 0000 [0002]
+ 0002 [0001]
. 0001 [0001]
> 0000 [0001]
