_ 0000 [0000]
_ 0000 [0000]
[ 0005 [0000]
. 0002 [0000]
] 0003 [0000]
[ 0023 [0000]
, 0001 [0000]
. 0001 [0000]
[ 0011 [0000]
. 0001 [0000]
] 0009 [0000]
, 0001 [0000]
. 0002 [0000]
, 0003 [0000]
+ 0001 [0000]
, 0001 [0000]
+ -001 [0000]
, 0001 [0000]
, 0001 [0000]
[ 0021 [0000]
] 0020 [0000]
. 0002 [0000]
] 0006 [0000]
+ 0008 [0000]
[ 0045 [0000]
+ 0004 [0001]
> 0000 [0001]
[ 0034 [0000]
+ 0002 [0001]
+ 0003 [0002]
+ 0003 [0003]
+ 0001 [0004]
+ -001 [0000]
] 0028 [0000]
+ 0001 [0001]
+ 0001 [0002]
+ -001 [0003]
+ 0001 [0005]
> 0000 [0005]
[ 0042 [0000]
> 0000 [-001]
] 0040 [0000]
+ -001 [-001]
> 0000 [-001]
] 0025 [0000]
. 0001 [0002]
+ -003 [0003]
. 0001 [0003]
+ 0007 [0003]
. 0002 [0003]
+ 0003 [0003]
. 0001 [0003]
. 0001 [0005]
+ -001 [0004]
. 0001 [0004]
. 0001 [0003]
+ 0003 [0003]
. 0001 [0003]
+ -006 [0003]
. 0001 [0003]
+ -008 [0003]
. 0001 [0003]
+ 0001 [0005]
. 0001 [0005]
+ 0002 [0006]
. 0001 [0006]
> 0000 [0006]
