> 0000, [ 0003
> 0000, . 0002
> 0000, ] -001
> 0000, [ 0020
> 0000, , 0001
> 0000, . 0001
> 0000, [ 0009
> 0000, . 0001
> 0000, ] -001
> 0000, , 0001
> 0000, . 0002
> 0000, , 0003
> 0000, + 0001
> 0000, , 0001
> 0000, + -001
> 0000, , 0002
> 0000, [ 0018
> 0000, ] 0000
> 0000, . 0002
> 0000, ] -015
> 0000, + 0008
> 0000, [ 0036
> 0001, + 0004
> 0000, T 0004
> 0001, t 0002
> 0002, t 0003
> 0003, t 0003
> 0004, t 0001
> 0001, + 0001
> 0001, + 0001
> 0001, + -001
> 0002, + 0001
> 0000, [ 0034
> -001, ] 0000
> -001, + -001
> 0000, ] -013
> 0002, . 0001
> 0001, + -003
> 0000, . 0001
> 0000, + 0007
> 0000, . 0002
> 0000, + 0003
> 0000, . 0001
> 0002, . 0001
> -001, + -001
> 0000, . 0001
> -001, . 0001
> 0000, + 0003
> 0000, . 0001
> 0000, + -006
> 0000, . 0001
> 0000, + -008
> 0000, . 0001
> 0002, + 0001
> 0000, . 0001
> 0001, + 0002
> 0000, . 0001
> 0000, 0 0000
