(0000) > 0000, [ 0003
(0001) > 0000, . 0002
(0002) > 0000, ] 0001
(0003) > 0000, [ 0021
(0004) > 0000, , 0001
(0005) > 0000, . 0001
(0006) > 0000, [ 0009
(0007) > 0000, . 0001
(0008) > 0000, ] 0007
(0009) > 0000, , 0001
(0010) > 0000, . 0002
(0011) > 0000, , 0003
(0012) > 0000, + 0001
(0013) > 0000, , 0001
(0014) > 0000, + -001
(0015) > 0000, , 0001
(0016) > 0000, , 0001
(0017) > 0000, [ 0019
(0018) > 0000, ] 0018
(0019) > 0000, . 0002
(0020) > 0000, ] 0004
(0021) > 0000, + 0008
(0022) > 0000, [ 0039
(0023) > 0001, + 0004
(0024) > 0000, [ 0031
(0025) > 0001, + 0002
(0026) > 0001, + 0003
(0027) > 0001, + 0003
(0028) > 0001, + 0001
(0029) > -004, + -001
(0030) > 0000, ] 0025
(0031) > 0001, + 0001
(0032) > 0001, + 0001
(0033) > 0001, + -001
(0034) > 0002, + 0001
(0035) > 0000, [ 0037
(0036) > -001, ] 0036
(0037) > -001, + -001
(0038) > 0000, ] 0023
(0039) > 0002, . 0001
(0040) > 0001, + -003
(0041) > 0000, . 0001
(0042) > 0000, + 0007
(0043) > 0000, . 0002
(0044) > 0000, + 0003
(0045) > 0000, . 0001
(0046) > 0002, . 0001
(0047) > -001, + -001
(0048) > 0000, . 0001
(0049) > -001, . 0001
(0050) > 0000, + 0003
(0051) > 0000, . 0001
(0052) > 0000, + -006
(0053) > 0000, . 0001
(0054) > 0000, + -008
(0055) > 0000, . 0001
(0056) > 0002, + 0001
(0057) > 0000, . 0001
(0058) > 0001, + 0002
(0059) > 0000, . 0001
(0060) > 0000, 0 0000
