(0000) _ 0000 [0000]
(0001) _ 0000 [0000]
(0002) _ 0000 [0000]
(0003) [ 0006 [0000]
(0004) . 0002 [0000]
(0005) ] 0004 [0000]
(0006) [ 0024 [0000]
(0007) , 0001 [0000]
(0008) . 0001 [0000]
(0009) [ 0012 [0000]
(0010) . 0001 [0000]
(0011) ] 0010 [0000]
(0012) , 0001 [0000]
(0013) . 0002 [0000]
(0014) , 0003 [0000]
(0015) + 0001 [0000]
(0016) , 0001 [0000]
(0017) + -001 [0000]
(0018) , 0001 [0000]
(0019) , 0001 [0000]
(0020) [ 0022 [0000]
(0021) ] 0021 [0000]
(0022) . 0002 [0000]
(0023) ] 0007 [0000]
(0024) + 0008 [0000]
(0025) [ 0040 [0000]
(0026) + 0004 [0001]
(0027) x 0004 [0001]
(0028) + 0002 [0001]
(0029) + 0003 [0002]
(0030) + 0003 [0003]
(0031) + 0001 [0004]
(0032) + 0001 [0002]
(0033) + 0001 [0003]
(0034) + -001 [0004]
(0035) + 0001 [0006]
(0036) ^ -001 [0006]
(0037) + -001 [0005]
(0038) > 0000 [0005]
(0039) ] 0026 [0000]
(0040) . 0001 [0002]
(0041) + -003 [0003]
(0042) . 0001 [0003]
(0043) + 0007 [0003]
(0044) . 0002 [0003]
(0045) + 0003 [0003]
(0046) . 0001 [0003]
(0047) . 0001 [0005]
(0048) + -001 [0004]
(0049) . 0001 [0004]
(0050) . 0001 [0003]
(0051) + 0003 [0003]
(0052) . 0001 [0003]
(0053) + -006 [0003]
(0054) . 0001 [0003]
(0055) + -008 [0003]
(0056) . 0001 [0003]
(0057) + 0001 [0005]
(0058) . 0001 [0005]
(0059) + 0002 [0006]
(0060) . 0001 [0006]
(0061) > 0000 [0006]
(0062) 0 0000 [0000]
