(0000) [ 0003
(0001) . 0002
(0002) ] 0001
(0003) [ 0023
(0004) , 0001
(0005) . 0001
(0006) [ 0009
(0007) . 0001
(0008) ] 0007
(0009) , 0001
(0010) . 0002
(0011) , 0003
(0012) + 0001
(0013) , 0001
(0014) + -001
(0015) , 0001
(0016) > -001
(0017) > 0001
(0018) , 0001
(0019) [ 0021
(0020) ] 0020
(0021) . 0002
(0022) ] 0004
(0023) + 0008
(0024) [ 0046
(0025) > 0001
(0026) + 0004
(0027) T 0004
(0028) 0001 0002
(0029) 0002 0003
(0030) 0003 0003
(0031) 0004 0001
(0032) > 0001
(0033) + 0001
(0034) > 0001
(0035) + 0001
(0036) > 0001
(0037) + -001
(0038) > 0002
(0039) + 0001
(0040) [ 0043
(0041) > -001
(0042) ] 0041
(0043) > -001
(0044) + -001
(0045) ] 0025
(0046) > 0002
(0047) . 0001
(0048) > 0001
(0049) + -003
(0050) . 0001
(0051) + 0007
(0052) . 0002
(0053) + 0003
(0054) . 0001
(0055) > 0002
(0056) . 0001
(0057) > -001
(0058) + -001
(0059) . 0001
(0060) > -001
(0061) . 0001
(0062) + 0003
(0063) . 0001
(0064) + -006
(0065) . 0001
(0066) + -008
(0067) . 0001
(0068) > 0002
(0069) + 0001
(0070) . 0001
(0071) > 0001
(0072) + 0002
(0073) . 0001
(0074) 0 0000
