> 0000, [ 0003
> 0000, . 0002
> 0000, ] 0001
> 0000, [ 0019
> 0000, , 0001
> 0000, . 0001
> 0000, [ 0009
> 0000, . 0001
> 0000, ] 0007
> 0000, , 0001
> 0000, . 0002
> 0000, , 0003
> 0000, + 0001
> 0000, , 0001
> 0000, + -001
> 0000, , 0002
> 0000, ] 0016
> 0000, . 0002
> 0000, ] 0004
> 0000, + 0008
> 0000, [ 0037
> 0001, + 0004
> 0000, [ 0029
> 0001, + 0002
> 0001, + 0003
> 0001, + 0003
> 0001, + 0001
> -004, + -001
> 0000, ] 0023
> 0001, + 0001
> 0001, + 0001
> 0001, + -001
> 0002, + 0001
> 0000, [ 0035
> -001, ] 0034
> -001, + -001
> 0000, ] 0021
> 0002, . 0001
> 0001, + -003
> 0000, . 0001
> 0000, + 0007
> 0000, . 0002
> 0000, + 0003
> 0000, . 0001
> 0002, . 0001
> -001, + -001
> 0000, . 0001
> -001, . 0001
> 0000, + 0003
> 0000, . 0001
> 0000, + -006
> 0000, . 0001
> 0000, + -008
> 0000, . 0001
> 0002, + 0001
> 0000, . 0001
> 0001, + 0002
> 0000, . 0001
> 0000, 0 0000
