(0000) > 0000, [ 0003
(0001) > 0000, . 0002
(0002) > 0000, ] 0001
(0003) > 0000, [ 0020
(0004) > 0000, , 0001
(0005) > 0000, . 0001
(0006) > 0000, [ 0009
(0007) > 0000, . 0001
(0008) > 0000, ] 0007
(0009) > 0000, , 0001
(0010) > 0000, . 0002
(0011) > 0000, , 0003
(0012) > 0000, + 0001
(0013) > 0000, , 0001
(0014) > 0000, + -001
(0015) > 0000, , 0002
(0016) > 0000, [ 0018
(0017) > 0000, ] 0017
(0018) > 0000, . 0002
(0019) > 0000, ] 0004
(0020) > 0000, + 0008
(0021) > 0000, [ 0036
(0022) > 0001, + 0004
(0023) > 0000, T 0004
(0024) > 0001, t 0002
(0025) > 0002, t 0003
(0026) > 0003, t 0003
(0027) > 0004, t 0001
(0028) > 0001, + 0001
(0029) > 0001, + 0001
(0030) > 0001, + -001
(0031) > 0002, + 0001
(0032) > 0000, [ 0034
(0033) > -001, ] 0033
(0034) > -001, + -001
(0035) > 0000, ] 0022
(0036) > 0002, . 0001
(0037) > 0001, + -003
(0038) > 0000, . 0001
(0039) > 0000, + 0007
(0040) > 0000, . 0002
(0041) > 0000, + 0003
(0042) > 0000, . 0001
(0043) > 0002, . 0001
(0044) > -001, + -001
(0045) > 0000, . 0001
(0046) > -001, . 0001
(0047) > 0000, + 0003
(0048) > 0000, . 0001
(0049) > 0000, + -006
(0050) > 0000, . 0001
(0051) > 0000, + -008
(0052) > 0000, . 0001
(0053) > 0002, + 0001
(0054) > 0000, . 0001
(0055) > 0001, + 0002
(0056) > 0000, . 0001
(0057) > 0000, 0 0000
