(0000) [ 0003 [0000]
(0001) . 0002 [0000]
(0002) ] 0001 [0000]
(0003) [ 0021 [0000]
(0004) , 0001 [0000]
(0005) . 0001 [0000]
(0006) [ 0009 [0000]
(0007) . 0001 [0000]
(0008) ] 0007 [0000]
(0009) , 0001 [0000]
(0010) . 0002 [0000]
(0011) , 0003 [0000]
(0012) + 0001 [0000]
(0013) , 0001 [0000]
(0014) + -001 [0000]
(0015) , 0001 [0000]
(0016) , 0001 [0000]
(0017) [ 0019 [0000]
(0018) ] 0018 [0000]
(0019) . 0002 [0000]
(0020) ] 0004 [0000]
(0021) + 0008 [0000]
(0022) [ 0036 [0000]
(0023) + 0004 [0001]
(0024) x 0004 [0001]
(0025) + 0002 [0001]
(0026) + 0003 [0002]
(0027) + 0003 [0003]
(0028) + 0001 [0004]
(0029) + 0001 [0002]
(0030) + 0001 [0003]
(0031) + -001 [0004]
(0032) + 0001 [0006]
(0033) ^ -001 [0006]
(0034) + -001 [0005]
(0035) ] 0023 [0005]
(0036) . 0001 [0002]
(0037) + -003 [0003]
(0038) . 0001 [0003]
(0039) + 0007 [0003]
(0040) . 0002 [0003]
(0041) + 0003 [0003]
(0042) . 0001 [0003]
(0043) . 0001 [0005]
(0044) + -001 [0004]
(0045) . 0001 [0004]
(0046) . 0001 [0003]
(0047) + 0003 [0003]
(0048) . 0001 [0003]
(0049) + -006 [0003]
(0050) . 0001 [0003]
(0051) + -008 [0003]
(0052) . 0001 [0003]
(0053) + 0001 [0005]
(0054) . 0001 [0005]
(0055) + 0002 [0006]
(0056) . 0001 [0006]
(0057) 0 0000 [0006]
