_ 0000 [0000]
[ 0004 [0000]
. 0002 [0000]
] 0002 [0000]
[ 0022 [0000]
, 0001 [0000]
. 0001 [0000]
[ 0010 [0000]
. 0001 [0000]
] 0008 [0000]
, 0001 [0000]
. 0002 [0000]
, 0003 [0000]
+ 0001 [0000]
, 0001 [0000]
+ -001 [0000]
, 0001 [0000]
, 0001 [0000]
[ 0020 [0000]
] 0019 [0000]
. 0002 [0000]
] 0005 [0000]
+ 0008 [0000]
[ 0044 [0000]
+ 0004 [0001]
> 0000 [0001]
[ 0033 [0000]
+ 0002 [0001]
+ 0003 [0002]
+ 0003 [0003]
+ 0001 [0004]
+ -001 [0000]
] 0027 [0000]
+ 0001 [0001]
+ 0001 [0002]
+ -001 [0003]
+ 0001 [0005]
> 0000 [0005]
[ 0041 [0000]
> 0000 [-001]
] 0039 [0000]
+ -001 [-001]
> 0000 [-001]
] 0024 [0000]
. 0001 [0002]
+ -003 [0003]
. 0001 [0003]
+ 0007 [0003]
. 0002 [0003]
+ 0003 [0003]
. 0001 [0003]
. 0001 [0005]
+ -001 [0004]
. 0001 [0004]
. 0001 [0003]
+ 0003 [0003]
. 0001 [0003]
+ -006 [0003]
. 0001 [0003]
+ -008 [0003]
. 0001 [0003]
+ 0001 [0005]
. 0001 [0005]
+ 0002 [0006]
. 0001 [0006]
> 0000 [0006]
