(0000) > 0000, [ 0003
(0001) > 0000, . 0002
(0002) > 0000, ] 0001
(0003) > 0000, [ 0023
(0004) > 0000, , 0001
(0005) > 0000, . 0001
(0006) > 0000, [ 0009
(0007) > 0000, . 0001
(0008) > 0000, ] 0007
(0009) > 0000, , 0001
(0010) > 0000, . 0002
(0011) > 0000, , 0003
(0012) > 0000, + 0001
(0013) > 0000, , 0001
(0014) > 0000, + -001
(0015) > 0000, , 0001
(0016) > 0000, > -001
(0017) > 0000, > 0001
(0018) > 0000, , 0001
(0019) > 0000, [ 0021
(0020) > 0000, ] 0020
(0021) > 0000, . 0002
(0022) > 0000, ] 0004
(0023) > 0000, + 0008
(0024) > 0000, [ 0046
(0025) > 0000, > 0001
(0026) > 0000, + 0004
(0027) > 0000, T 0004
(0028) > 0001, t 0002
(0029) > 0002, t 0003
(0030) > 0003, t 0003
(0031) > 0004, t 0001
(0032) > 0000, > 0001
(0033) > 0000, + 0001
(0034) > 0000, > 0001
(0035) > 0000, + 0001
(0036) > 0000, > 0001
(0037) > 0000, + -001
(0038) > 0000, > 0002
(0039) > 0000, + 0001
(0040) > 0000, [ 0043
(0041) > 0000, > -001
(0042) > 0000, ] 0041
(0043) > 0000, > -001
(0044) > 0000, + -001
(0045) > 0000, ] 0025
(0046) > 0000, > 0002
(0047) > 0000, . 0001
(0048) > 0000, > 0001
(0049) > 0000, + -003
(0050) > 0000, . 0001
(0051) > 0000, + 0007
(0052) > 0000, . 0002
(0053) > 0000, + 0003
(0054) > 0000, . 0001
(0055) > 0000, > 0002
(0056) > 0000, . 0001
(0057) > 0000, > -001
(0058) > 0000, + -001
(0059) > 0000, . 0001
(0060) > 0000, > -001
(0061) > 0000, . 0001
(0062) > 0000, + 0003
(0063) > 0000, . 0001
(0064) > 0000, + -006
(0065) > 0000, . 0001
(0066) > 0000, + -008
(0067) > 0000, . 0001
(0068) > 0000, > 0002
(0069) > 0000, + 0001
(0070) > 0000, . 0001
(0071) > 0000, > 0001
(0072) > 0000, + 0002
(0073) > 0000, . 0001
(0074) > 0000, 0 0000
