(0000) [ 0003
(0001) . 0002
(0002) ] 0001
(0003) [ 0023
(0004) , 0001
(0005) . 0001
(0006) [ 0009
(0007) . 0001
(0008) ] 0007
(0009) , 0001
(0010) . 0002
(0011) , 0003
(0012) + 0001
(0013) , 0001
(0014) + -001
(0015) , 0001
(0016) > -001
(0017) > 0001
(0018) , 0001
(0019) [ 0021
(0020) ] 0020
(0021) . 0002
(0022) ] 0004
(0023) + 0008
(0024) [ 0053
(0025) > 0001
(0026) + 0004
(0027) [ 0039
(0028) > 0001
(0029) + 0002
(0030) > 0001
(0031) + 0003
(0032) > 0001
(0033) + 0003
(0034) > 0001
(0035) + 0001
(0036) > -004
(0037) + -001
(0038) ] 0028
(0039) > 0001
(0040) + 0001
(0041) > 0001
(0042) + 0001
(0043) > 0001
(0044) + -001
(0045) > 0002
(0046) + 0001
(0047) [ 0050
(0048) > -001
(0049) ] 0048
(0050) > -001
(0051) + -001
(0052) ] 0025
(0053) > 0002
(0054) . 0001
(0055) > 0001
(0056) + -003
(0057) . 0001
(0058) + 0007
(0059) . 0002
(0060) + 0003
(0061) . 0001
(0062) > 0002
(0063) . 0001
(0064) > -001
(0065) + -001
(0066) . 0001
(0067) > -001
(0068) . 0001
(0069) + 0003
(0070) . 0001
(0071) + -006
(0072) . 0001
(0073) + -008
(0074) . 0001
(0075) > 0002
(0076) + 0001
(0077) . 0001
(0078) > 0001
(0079) + 0002
(0080) . 0001
(0081) 0 0000
