(0000) _ 0000 [0000]
(0001) _ 0000 [0000]
(0002) _ 0000 [0000]
(0003) [ 0006 [0000]
(0004) . 0002 [0000]
(0005) ] 0004 [0000]
(0006) [ 0024 [0000]
(0007) , 0001 [0000]
(0008) . 0001 [0000]
(0009) [ 0012 [0000]
(0010) . 0001 [0000]
(0011) ] 0010 [0000]
(0012) , 0001 [0000]
(0013) . 0002 [0000]
(0014) , 0003 [0000]
(0015) + 0001 [0000]
(0016) , 0001 [0000]
(0017) + -001 [0000]
(0018) , 0001 [0000]
(0019) , 0001 [0000]
(0020) [ 0022 [0000]
(0021) ] 0021 [0000]
(0022) . 0002 [0000]
(0023) ] 0007 [0000]
(0024) + 0008 [0000]
(0025) [ 0041 [0000]
(0026) + 0004 [0001]
(0027) > 0000 [0001]
(0028) x 0004 [0000]
(0029) + 0002 [0001]
(0030) + 0003 [0002]
(0031) + 0003 [0003]
(0032) + 0001 [0004]
(0033) + 0001 [0001]
(0034) + 0001 [0002]
(0035) + -001 [0003]
(0036) + 0001 [0005]
(0037) ^ -001 [0005]
(0038) + -001 [0004]
(0039) > 0000 [0004]
(0040) ] 0026 [0000]
(0041) . 0001 [0002]
(0042) + -003 [0003]
(0043) . 0001 [0003]
(0044) + 0007 [0003]
(0045) . 0002 [0003]
(0046) + 0003 [0003]
(0047) . 0001 [0003]
(0048) . 0001 [0005]
(0049) + -001 [0004]
(0050) . 0001 [0004]
(0051) . 0001 [0003]
(0052) + 0003 [0003]
(0053) . 0001 [0003]
(0054) + -006 [0003]
(0055) . 0001 [0003]
(0056) + -008 [0003]
(0057) . 0001 [0003]
(0058) + 0001 [0005]
(0059) . 0001 [0005]
(0060) + 0002 [0006]
(0061) . 0001 [0006]
(0062) > 0000 [0006]
