(0000) > 0, [ 0003
(0001) > 0, . 0002
(0002) > 0, ] 0001
(0003) > 0, [ 0023
(0004) > 0, , 0001
(0005) > 0, . 0001
(0006) > 0, [ 0009
(0007) > 0, . 0001
(0008) > 0, ] 0007
(0009) > 0, , 0001
(0010) > 0, . 0002
(0011) > 0, , 0003
(0012) > 0, + 0001
(0013) > 0, , 0001
(0014) > 0, + -001
(0015) > 0, , 0001
(0016) > 0, > -001
(0017) > 0, > 0001
(0018) > 0, , 0001
(0019) > 0, [ 0021
(0020) > 0, ] 0020
(0021) > 0, . 0002
(0022) > 0, ] 0004
(0023) > 0, + 0008
(0024) > 0, [ 0046
(0025) > 0, > 0001
(0026) > 0, + 0004
(0027) > 0, T 0004
(0028) > 1, t 0002
(0029) > 2, t 0003
(0030) > 3, t 0003
(0031) > 4, t 0001
(0032) > 0, > 0001
(0033) > 0, + 0001
(0034) > 0, > 0001
(0035) > 0, + 0001
(0036) > 0, > 0001
(0037) > 0, + -001
(0038) > 0, > 0002
(0039) > 0, + 0001
(0040) > 0, [ 0043
(0041) > 0, > -001
(0042) > 0, ] 0041
(0043) > 0, > -001
(0044) > 0, + -001
(0045) > 0, ] 0025
(0046) > 0, > 0002
(0047) > 0, . 0001
(0048) > 0, > 0001
(0049) > 0, + -003
(0050) > 0, . 0001
(0051) > 0, + 0007
(0052) > 0, . 0002
(0053) > 0, + 0003
(0054) > 0, . 0001
(0055) > 0, > 0002
(0056) > 0, . 0001
(0057) > 0, > -001
(0058) > 0, + -001
(0059) > 0, . 0001
(0060) > 0, > -001
(0061) > 0, . 0001
(0062) > 0, + 0003
(0063) > 0, . 0001
(0064) > 0, + -006
(0065) > 0, . 0001
(0066) > 0, + -008
(0067) > 0, . 0001
(0068) > 0, > 0002
(0069) > 0, + 0001
(0070) > 0, . 0001
(0071) > 0, > 0001
(0072) > 0, + 0002
(0073) > 0, . 0001
(0074) > 0, 0 0000
