> 0000, [ 0003
> 0000, . 0002
> 0000, ] 0001
> 0000, [ 0020
> 0000, , 0001
> 0000, . 0001
> 0000, [ 0009
> 0000, . 0001
> 0000, ] 0007
> 0000, , 0001
> 0000, . 0002
> 0000, , 0003
> 0000, + 0001
> 0000, , 0001
> 0000, + -001
> 0000, , 0002
> 0000, [ 0018
> 0000, ] 0017
> 0000, . 0002
> 0000, ] 0004
> 0000, + 0008
> 0000, [ 0036
> 0001, + 0004
> 0001, T 0004
> 0002, t 0002
> 0003, t 0003
> 0004, t 0003
> 0005, t 0001
> 0002, + 0001
> 0003, + 0001
> 0004, + -001
> 0006, + 0001
> 0006, [ 0034
> -001, ] 0033
> -001, + -001
> -001, ] 0022
> 0002, . 0001
> 0003, + -003
> 0003, . 0001
> 0003, + 0007
> 0003, . 0002
> 0003, + 0003
> 0003, . 0001
> 0005, . 0001
> 0004, + -001
> 0004, . 0001
> 0003, . 0001
> 0003, + 0003
> 0003, . 0001
> 0003, + -006
> 0003, . 0001
> 0003, + -008
> 0003, . 0001
> 0005, + 0001
> 0005, . 0001
> 0006, + 0002
> 0006, . 0001
> 0006, 0 0000
