(0000) [ 0003 [0000]
(0001) . 0002 [0000]
(0002) ] 0001 [0000]
(0003) [ 0023 [0000]
(0004) , 0001 [0000]
(0005) . 0001 [0000]
(0006) [ 0009 [0000]
(0007) . 0001 [0000]
(0008) ] 0007 [0000]
(0009) , 0001 [0000]
(0010) . 0002 [0000]
(0011) , 0003 [0000]
(0012) + 0001 [0000]
(0013) , 0001 [0000]
(0014) + -001 [0000]
(0015) , 0001 [0000]
(0016) > 0000 [-001]
(0017) > 0000 [0001]
(0018) , 0001 [0000]
(0019) [ 0021 [0000]
(0020) ] 0020 [0000]
(0021) . 0002 [0000]
(0022) ] 0004 [0000]
(0023) + 0008 [0000]
(0024) [ 0053 [0000]
(0025) > 0000 [0001]
(0026) + 0004 [0000]
(0027) [ 0039 [0000]
(0028) > 0000 [0001]
(0029) + 0002 [0000]
(0030) > 0000 [0001]
(0031) + 0003 [0000]
(0032) > 0000 [0001]
(0033) + 0003 [0000]
(0034) > 0000 [0001]
(0035) + 0001 [0000]
(0036) > 0000 [-004]
(0037) + -001 [0000]
(0038) ] 0028 [0000]
(0039) > 0000 [0001]
(0040) + 0001 [0000]
(0041) > 0000 [0001]
(0042) + 0001 [0000]
(0043) > 0000 [0001]
(0044) + -001 [0000]
(0045) > 0000 [0002]
(0046) + 0001 [0000]
(0047) [ 0050 [0000]
(0048) > 0000 [-001]
(0049) ] 0048 [0000]
(0050) > 0000 [-001]
(0051) + -001 [0000]
(0052) ] 0025 [0000]
(0053) > 0000 [0002]
(0054) . 0001 [0000]
(0055) > 0000 [0001]
(0056) + -003 [0000]
(0057) . 0001 [0000]
(0058) + 0007 [0000]
(0059) . 0002 [0000]
(0060) + 0003 [0000]
(0061) . 0001 [0000]
(0062) > 0000 [0002]
(0063) . 0001 [0000]
(0064) > 0000 [-001]
(0065) + -001 [0000]
(0066) . 0001 [0000]
(0067) > 0000 [-001]
(0068) . 0001 [0000]
(0069) + 0003 [0000]
(0070) . 0001 [0000]
(0071) + -006 [0000]
(0072) . 0001 [0000]
(0073) + -008 [0000]
(0074) . 0001 [0000]
(0075) > 0000 [0002]
(0076) + 0001 [0000]
(0077) . 0001 [0000]
(0078) > 0000 [0001]
(0079) + 0002 [0000]
(0080) . 0001 [0000]
(0081) 0 0000 [0000]
